I am a boy.	Yo soy un niño.
The boy, the girl	El niño, la niña.
A girl	Una niña.
I am a man	Yo soy un hombre.
The woman	La mujer.
The man	El hombre.
A man	Un hombre.
A woman	Una mujer.
I am a woman	Yo soy una mujer.
I am a girl	Yo soy una niña.
He eats	Él come.
She eats	Ella come.
She is a girl	Ella es una niña.
You are a woman	Tú eres una mujer.
You eat	Usted come.
He is a man	Él es un hombre.
You are a girl	Tú eres una niña.
You are a man	Usted es un hombre.
An apple	Una manzana.
She is a woman	Ella es una mujer.
She drinks milk	Ella bebe leche.
I drink water	Yo bebo agua.
You eat bread.	Tú comes pan.
I eat bread	Yo como pan.
You drink	Tú bebes.
You drink milk	Tú bebes leche.
He drinks water	Él bebe agua.
The bread	El pan.
The water	El aqua.
He drinks milk	Él bebe leche.
You eat an apple	Tú comes una manzana.
You drink water	Tú bebes agua.
The man drinks milk	El hombre bebe leche.
Thank you, goodbye	Gracias, adiós.
Hello, good morning	Hola, buenos días.
Goodbye, good night	Adiós, buenas noches.
Hello, nice to meet you.	Hola, mucho gusto.
No, thank you.	No, per favor.
Yes, I am sorry	Sí, ¡lo siento!
Yes, you're welcome	Si, de nada.
pardon	Perdon.
Mo excuse me	No perdon.
Per favor no	Please no.
I do not speak Spanish.	Yo no hablo español.
I speak English.	Yo hablo inglés.
Do you speak English?	¿Tú hablas inglés?
Do you speak Spanish. 	¿Tú hablas español?
Thank you. Thank you, excuse me.	Gracias, disculpe.
Hello, excuse me.	Hola, disculpe.
I speak English.	Yo hablo inglés.
The suitcase	La maleta.
The taxi	El taxi.
The telephone	El teléfono.
The passport	El pasaporte.
I need water.	Yo necesito agua.
I need my suitcase.	Yo necesito mi maleta.
Here, please.	Aquí, por favor.
I need a reservation.	Yo necesito una reserva.
I need a hotel.	Yo necesito un hotel.
In the suitcase.	En la maleta.
Where?	¿Dónde?
I have a passport.	Yo tengo un pasaporte.
The money.	El dinero.
The airport.	El aeropuerto.
The train.	El tren. 
In the bus.	En el autobús.
Where is your passport?	¿Dónde está tu pasaporte?
I need a ticket.	Yo necesito un boleto.
A bus.	Un autobús.
A ticket please.	Un boleto, por favor.
In the street.	En la calle. 
The bathroom is here.	El baño está aquí.
A bank.	Un banco.
A museum.	Un museo.
A supermarket.	Un supermercado.
Where is the hospital?	¿Dónde está el hospital?
The table.	La mesa.
The restaurant.	El restaurante.
The people.	Las personas.
One two three!	¡Uno, dos, tres!
A table for two, please.	Una mesa para dos, por favor. 
The restaurant is closed.	El restaurante está cerrado.
For three people.	Para tres personas. 
The fish.	El pescado.
The meat.	La carne.
The cheese.	El queso.
The sandwich.	El sándwich.
A hamburger please.	Una hamburguesa, por favor.
A meat sandwich.	Un sándwich de carne.
Con queso. With cheese.
A fish burger.	Una hamburguesa de pescado.
The cup.	La taza.
The sugar.	El azúcar.
The orange.	La naranja. 
The coffee.	El café.
The juice.	El jugo.
The glass.	Un vaso.
Without milk, please.	Sin leche, por favor.
The tomato.	El tomate.
The salt.	La sal.
Meat or fish?	¿Carne o pescado? 
The bill please.	La cuenta, por favor.
A salad.	Una ensalada.
I need to pay.	Yo necesito pagar.
I want to pay.	Yo quiero pagar.
A green shirt.	Una camisa verde.
I need clothes.	Yo necesito ropa.
A store.	Una tienda.
A blue jacket.	Una chaqueta azul.
I want a jacket.	Yo quiero una chaqueta.
I need a shirt.	Yo necesito una camisa.
Green or blue?	¿Verde o azul?
I need a t-shirt.	Yo necesito una camiseta.
I want to buy a jacket.	Yo quiero comprar una chaqueta.
Grey or brown.	¿Gris o marrón?
Yes, this hat.	Sí, este sombrero.
A dress.	Un vestido.
A grey dress.	Un vestido gris.
A brown hat.	Un sombrero marrón.
I want a t-shirt.	Yo quiero una camiseta.
A cheap dress.	Un vestido barato.
That hat.	Ese sombero.
An expensive hat.	Un sombero caro.
Una tienda diferente A different store.
I need a red dress.	Yo necesito un traje rojo.
A coat	Un abrigo.
A skirt	Una falda.
This watch is too expensive	Este reloj es demasiado caro.
A need a purse.	Yo necesito una cartera.
I want comfortable clothes 	Yo quiero ropa cómoda.
A gift for my daughter.	Un regalo para mi hija.
An expensive belt.	Un cinturón caro.
My favourite store.	Mi tienda favorita.
A blue purse.	Un careta azul.
A brown belt.	Un cinturón marrón.
Good bye, good night.	Adiós, buenas noches.
Hello, good morning.	Hola, buenos días.
Thank good, good night.	Gracias, buenas noches.
Hello, pleased to meet you.	Hola, mucho gusto.
Thanks, bye.	Gracias, adiós.
The women	Las mujeres.
They are men.	Ellos son hombres.
The women drink water.	Las mujeres beben agua.
We are girls.	Nosotras somos niñas.
	Los hombres.	The men.
They drink.	Ellos benen.
The boys.	Los niños.
They are women	Ellas son mujeres.
I write a letter.	Yo escribo una carta.
You write a book.	Usted escribe un libro.
The wine. 	El vino.
The book	El libro.
We write.	Nosotros escribimos.
You write a book.	Tú escribes un libro.
I read a book.	Yo leo un libro.
The newspaper.	El diario.
She is a person.	Ella es una persona.
The boys write.	Los niños escriben.
You read.	Usted lee.
Ustedes leen. You read (pl)
We read the newspaper.	Nosotras leemos el diario.
I am a person.	Yo soy una persona.
You read a book.	Tú lees un libro.
The book	El libro.
The class	La clase.
The teacher	El maestro.
The pen	El bolígrafo.
Very easy.	Muy fácil.
My school.	Mi escuela.
A Spanish exam.	Un examen de español.
My Spanish teacher.	Mi maestro de español.
An easy class.	Una clase fácil.
An interesting problem.	Un problema interesante.
A student.	Un estudiante.
I need to write in Spanish.	Yo necesito escribir en español.
I need to study.	Yo necesito estudiar.
A difficult exam.	Un examen difícil.
I need to read.	Yo necesito leer.
I have a question.	Yo tengo una pregunta.
I have a problem.	Yo tengo un problema.
An important class.	Una clase importante.
I write in Spanish.	Yo escribo en español.
I am not a student.	Yo no soy estudiante.
I understand.	Yo comprendo.
I study Spanish.	Yo estudio español.
I do not understand.	Yo no comprendo.
I read in Spanish.	Yo leo en español.
I study a lot.	Yo estudio mucho.
Yo leo con mi maestro. I read with my teacher.
The computer.	La computadora.
The university.	La universidad.
The professor.	El profesor.
You write in Spanish?	¿Tú escribes en español?
You study Spanish?	¿Tú estudias español?
I study medicine.	Yo estudio medicina.
You read a lot?	¿Tú lees mucho?
I study in the university.	Yo estudio en la universidad.
Well, and you?	Bien, ¿y tú?
No, I am not well	No, no estoy bien.
She is well.	Ella está bien.
She is tired.	Ella está cansada.
He is tired.	Él está cansado.
You are not well?	¿No estás bien?
Hello, how are you?	Hola, ¿cómo estás?
How are you?	¿Cómo estás?
Good night, madam.	Buenas noches, señora.
Thank you, see you later.	Gracias, hasta luego.
Hello, good afternoon.	Hola, buenas tardes.
Goodbye, see you tomorrow!	¡Adiós, hasta mañana!
Good morning, sir.	Buenos días, señor.
Buenos días, señorita. Good morning, miss
How are you, sir?	¿Cómo está usted, señor?
Good afternnon, how are you?	Buenas tardes, ¿cómo está usted?
The lady is busy.	La señora está ocupada.
Excuse me, are you unwell?	Perdón, ¿estás mal?
Miss, what is your name?	Señorita, ¿cómo se llama usted?
Excuse me sir, are you busy?	Disculpe señor, ¿está usted ocupado?
Good morning, what is your name?	Buenos días, ¿cómo te llamas?
I am happy.	Estoy feliz.
I am not very happy.	No estoy muy feliz.
Excuse me, sir, what is your name?	Perdón, señor, ¿cómo se llama?
The man is unwell.	El hombre está mal.
The coffee.	El café.
The tea.	El té.
The banana.	La banana.
You don't want bread?	¿Tú no quieres pan?
Sir, do you want some water?	Señor, ¿quiere usted agua?
I want milk.	Yo quiero leche.
He wants more bread.	Él quiere más pan.
Do you want a coffee?	¿Quieres un café?
The boy wants bread.	El niño quiere pan.
Thank you, I do not want a tea.	Gracias, yo no quiero un té.
The car.	El carro.
The taxi.	El taxi.
The money.	El dinero.
He does not need more water.	Él no necesita más agua.
I need apples.	Yo necesito manzanas.
Do you need milk	¿Necesitas leche?
I need help, please.	Yo necesito ayuda, por favor.
You do not need a taxi.	Tú no necesitas un taxi.
He does not need more money.	Él no necesita más dinero.
The pen.	El bolígrafo.
The telephone.	El teléfono.
The computer.	La computadora.
No, I don't need to use the car.	No, yo no necesito usar el carro.
I use the car.	Yo uso el carro.
You use the car?	¿Tú usas el carro?
No, she does not use the computer.	No, ella no usa la computadora.
The man uses the telephone.	El hombre usa el teléfono.
The boy needs a pen.	El niño necesita un bolígrafo.
The purse.	La cartera.
The passport.	El pasaporte.
Do you have the telephone?	¿Tienes el teléfono?
I need my ticket.	Yo necesito mi boleto.
Yes, I have a car.	Sí, yo tengo un carro.
I do not need a suitcase.	Yo no necesito una maleta.
He has the ticket and the passport.	Él tiene el boleto y el pasaporte.
Do you have my purse.	¿Tú tienes mi cartera?
She has a suitcase.	Ella tiene una maleta.
Zero 	Cero
Two 	Dos
Three 	Tres
Four 	Cuatro
Five	Cinco
Six	Seis
Seven	Siete
Eight	Ocho
Nine	Nueve
Ten	Diez
Eleven	Once
Twelve	Doce
Thirteen	Trece
Fourteen	Catorce
Fifteen	Quince
Sixteen	Qieciséis
Seventeen	Diecisiete
Eighteen	Dieciocho
Nineteen	Diecinueve
Twenty	Veinte
Twenty-One	Veintiuno
Thirty	Treinta
Forty	Cuarenta
Fifty	Cincuenta
Sixty	Sesenta
Seventy	Setenta
Eighty	Ochenta
Ninety	Noventa
One Hundred	Cien
Two Hundred	Doscientos
Three Hundred	Rrescientos
One Thousand	Mil
Today is Thursday.	Hoy es jueves.
The match is on Friday.	El partido es el viernes.
My birthday is not on Tuesday.	Mi cumpleaños no es el martes.
The baseball match is on Tuesday.	El partido de béisbol es el martes.
Is today Wednesday?	¿Hoy es miércoles?
Today is my birthday.	Hoy es mi cumpleaños.
What day is it today?	¿Qué día es hoy?
The baseball match is on Thursday.	El partido de béisbol es el jueves.
Yes, today is Wednesday.	Sí, hoy es miércoles.
Tomorrow is Friday.	Mañana es viernes.
The party.	La fiesta.
Tomorrow is Sunday.	Mañana es domingo.
Baseball is a lot of fun.	El béisbol es muy divertido.
Tomorrow is Saturday.	Mañana es sábado.
The concert is on Tuesday.	¿El concierto es el martes?
When is your birthday?	¿Cuándo es tu cumpleaños?
Is the party fun?	¿Es divertida la fiesta?
Today is Saturday	Hoy es sábado.
The match is on Sunday.	El partido es el domingo.
The dance.	El baile.
The movie	La película.
My favourite concert.	Mi concierto favorito.
A week in Mexico.	Una semana en México.
It is my favourite party.	Es mi fiesta favorita.
Enjoy Friday!	¡Disfruta el viernes!
Happy weekend!	¡Feliz fin de semana!
The dance is tomorrow.	El baile es mañana.
The movie is today?	¿La película es hoy?
Enjoy the weekend.	¡Disfruta el fin de semana!
I speak French	Yo hablo francés.
Ma'am do you speak English	Señora, ¿usted habla inglés?
No I do not study English.	No, yo no estudio inglés.
Do you want to speak Spanish	¿Tú quieres hablar español?
I need to study more	Yo necesito estudiar más.
Where do you study?	¿Dónde estudia usted? ¿Dónde estudias?
He wants to speak English.	Él quiere hablar inglés.
Do you want to study English.	¿Quieres estudiar inglés?
I study English and Spanish.	Yo estudio inglés y español.
The office.	La oficina.
Where do you work?	¿Dónde trabaja usted?
You work on Sunday?	¿Tú trabajas el domingo?
I do not work on Sunday.	Yo no trabajo el domingo.
Where do you want to work?	¿Dónde quieres trabajar?
Who speaks Spanish?	¿Quién habla español?
She does not work in a factory.	Ella no trabaja en una fábrica.
I work in an office.	Yo trabajo en una oficina.
You do not work today.	Tú no trabajas hoy.
Who studies French?	¿Quién estudia francés?
Who speaks Spanish?	¿Quién habla español?
The juice.	El jugo.
The sandwich.	El sándwich.
The meat.	La carne.
The wine.	El vino.
Yes, I want to drink more water.	Sí, yo quiero beber más agua.
You are eating a salad.	Tú comes una ensalada.
Yes, I want to eat more bread.	Sí, yo quiero comer más pan.
Yes, I want to drink more wine.	Sí, yo quiero beber más vino.
The boy eats a sandwich.	El niño come un sándwich.
The woman drinks juice.	La mujer bebe jugo.
I study French.	Yo estudio francés.
I do not want to speak Spanish.	Yo no quiero hablar español.
Do you not want to study Spanish? 	¿Tú no quieres estudiar español?
Yes, I study Spanish.	Sí, yo estudio español.
I want to speak Spanish.	Yo quiero hablar español.
Sir, do you speak Spanish?	Señor, ¿usted habla español?
The school.	La escuela.
The restaurant.	El restaurante.
The teacher.	El maestro. 
He is a waiter.	Él es camarero.
The teacher is not American.	La maestra no es americana.
I speak Portuguese and Spanish.	Yo hablo portugués y español.
She is a waitress.	¿Ella es camarera?
Do you speak Spanish in school?	¿Hablas español en la escuela?
Do you work in a restaurant?	¿Tú trabajas en un restaurante?
He is not a teacher.	Él no es maestro.
The teacher is Cuban.	La maestra es cubana.
She is a waitress.	Ella es camarera.
The number.	El número.
A young woman.	Una mujer joven.
I want to be a Spanish teacher.	Yo quiero ser maestro de español.
Do you have my address?	¿Tú tienes mi dirección?
She is my friend.	Ella es mi amiga.
She does not have a mobile phone.	Ella no tiene un celular.
He is my friend.	Él es mi amigo.
Do you want my phone number?	¿Quieres mi número de teléfono?
I am not young.	Yo no soy joven.
Yes, I want to be a french teacher.	Sí, yo quiero ser maestro de francés.
Do you have a mobile phone?	¿Tienes un celular?
Do you want my address?	¿Quieres mi dirección?
Do you work in a restaurant?	¿Tú trabajas en un restaurante?
I speak English at school	Yo hablo inglés en la escuela.
Ma'am, are you a waitress?	Señora es usted camarera?
The teacher is Mexican.	El maestro es mexicano.
The woman is a teacher.	La mujer es maestra.
You are very young.	Eres muy joven.
She does not have a mobile phone.	Ella no tiene un celular.
I do not have your address	Yo no tengo tu dirección.
She is your friend.	Ella es tu amiga.
He is my friend.	Él es mi amigo.
Yes, I have your address.	Sí, yo tengo tu dirección.
A young man.	Un hombre joven.
The books.	Los libros.
The pens.	Los bolígrafos.
Is it an interesting book?	¿Es un libro interesante?
I have a zero in English.	Yo tengo un cero en inglés.
The man has three pens.	El hombre tiene tres bolígrafos.
I have a book.	Yo tengo un libro.
I have three books.	Yo tengo tres libros.
The boy wants a book.	El niño quiere un libro.
La universidad. The university.
The library.	La biblioteca.
The computers.	Las computadoras.
I need to buy three pens.	Yo necesito comprar tres bolígrafos.
The boy has a question.	El niño tiene una pregunta.
The university has two libraries.	La universidad tiene dos bibliotecas.
The library needs to buy four books.	La biblioteca necesita comprar cuatro libros.
Yes, ma'am, I have a question.	Sí, señora, yo tengo una pregunta.
The library has two computers.	La biblioteca tiene dos computadoras.
Four pens.	Cuatro bolígrafos.
Yes, four libraries.	Sí, cuatro bibliotecas.
The boy wants to learn.	El niño quiere aprender.
She works at this university	Ella trabaja en esta universidad.
Do you learn English at the university.	¿Tú aprendes inglés en la universidad?
Are you using this pen?	¿Usas este bolígrafo?
I learn English at the university.	Yo aprendo inglés en la universidad.
Yes, he learns Spanish.	Sí, él aprende español.
Yes, I learn French	Sí, yo aprendo francés.
No, I do not need this computer.	No, no necesito esta computadora.
I do not need to learn French.	Yo no necesito aprender francés.
She does not learn!	Ella no aprende!
The student has two books	El estudiante tiene dos libros.
No, I do not have two pens.	No yo no tengo dos bolígrafos.
Rafael needs a book.	Rafael necesita un libro.
I have three books.	Yo tengo tres libros.
She is tall?	¿Ella es alta?
What pet do you want?	¿Qué mascota quieres?
I have a nice boyfriend.	Tengo un novio simpático.
Your daughter is very nice.	Tu hija es muy simpática.
My father is short.	Mi padre es bajo.
This girl is very short.	Esta niña es muy baja.
Are you tall?	¿Eres alto?
I do not have pets.	Yo no tengo mascotas.
My daughter is very tall.	Mi hija es muy alta.
My son wants a pet.	Mi hijo quiere una mascota.
His mother is not very nice.	Su madre no es muy simpática.
Who isn't nice in your family	¿Quién no es simpático en tu familia?
Yes, my mother is short.	Sí, mi madre es baja.
The grandfather.	El abuelo.
My sister is ten years old.	Mi hermana tiene diez años.
What is the name of the English woman?	¿Cómo se llama la mujer inglesa?
She is Spanish?	¿Ella es española?
You have a grandmother?	¿Tú tienes una abuela?
This boy is one year old.	Este niño tiene un año.
What is your grandfather's name?	¿Cómo se llama tu abuelo?
I am eight years old.	Yo tengo ocho años.
She has a Spanish grandmother.	Ella tiene una abuela española.
I am nine years old.	Yo tengo nueve años.
Where does your Spanish girlfriend live?	¿Dónde vive tu novia española?
My mother is English and lives in England.	Mi madre es inglesa y vive en Inglaterra.
I talk with the bosses.	Yo hablo con las jefas.
The messages for this week.	Los mensajes de esta semana.
The boss has a message.	El jefe tiene un mensaje.
The secretary has no messages.	La secretaria no tiene mensajes.
He has a job in a office.	Él tiene un trabajo en una oficina.
I need the pens, please.	Necesito los bolígrafos, por favor.
What is your boss' name?	¿Cómo se llama tu jefa?
The boss has two secretaries	El jefe tiene dos secretarias.
I have messages from the secretary.	Yo tengo los mensajes de la secretaria.
He talks with the secretaries.	Él habla con las secretarias.
The boss wants to drink more tea.	La jefa quiere beber más té.
This message is important.	Este mensaje es importante.
The secretary needs help with the work.	La secretaria necesita ayuda con el trabajo.
The desk.	El escritorio.
The boss writes in his office.	El jefe escribe en su oficina.
I need to write a message.	Necesito escribir un mensaje.
I write an important message.	Yo escribo un mensaje importante.
You write with a pen.	Tú escribes con un bolígrafo.
You work here?	¿Trabajas aquí?
The boss talks a lot.	El jefe habla mucho.
Do you have a desk in your office?	¿Tú tienes un escritorio en tu oficina?
This woman writes very well in English.	Esta mujer escribe muy bien en inglés.
I do not write with a pen.	Yo no escribo con un bolígrafo.
She needs to write your address.	Ella necesita escribir tu dirección.
The boss does not eat much.	El jefe no come mucho.
The secretary does not want to work here.	La secretaria no quiere trabajar aquí.
What is the problem?	¿Cuál es el problema?
The boss has a letter for the woman.	El jefe tiene una carta para la mujer.
Do you want my email address?	¿Quieres mi correo electrónico?
My boss works little on Thursdays.	Mi jefe trabaja poco los jueves.
I want to have an interesting job.	Yo quiero tener un trabajo interesante.
La secretaria escribe las cartas los lunes. The secretary writes letters on Mondays.
The boss has a problem?	¿El jefe tiene un problema?
The secretary works little on Fridays.	La secretaria trabaja poco los viernes.
Do you want to have a job?	¿Tú quieres tener un trabajo?
I need the letters for Monday.	Yo necesito las cartas para el lunes.
Miss, what is your telephone number?	Señorita, ¿cuál es su número de teléfono?
What is your email address?	¿Cuál es tu correo electrónico?
She works little in the office.	Ella trabaja poco en la oficina.
She is very excited.	Ella está muy emocionada.
Yes I want to eat with you today.	Sí, yo quiero comer contigo hoy.
I'm sorry I'm always busy	Lo siento, yo siempre estoy ocupado.
Good morning how are you	Buenos días, ¿qué tal está usted?
Do you want to eat with me today?	¿Quieres comer conmigo hoy?
I'm sorry, I am sick today.	Lo siento, yo estoy enfermo hoy.
The boy is very excited.	El niño está muy emocionado.
No, I am not sad.	No, yo no estoy triste.
My grandmother is sick.	Mi abuela está enferma.
Do you not want to work with me?	¿No quieres trabajar conmigo?
Hello, how are you?	Hola, ¿qué tal?
The girl has a dog and is very excited 	La niña tiene un perro y está muy emocionada.
The waiter is always very busy in the restaurant.	El camarero siempre está muy ocupado en el restaurante.
Your mother is sick?	¿Tu mamá está enferma?
I'm never bored in the class	Yo nunca estoy aburrido en la clase.
You also need a doctor	Tú también necesitas un médico.
My father is sick today.	Mi papá está enfermo hoy.
Today is my birthday and I am excited.	Hoy es mi cumpleaños y estoy emocionado.
I want to enjoy a coffee with my dad.	Quiero disfrutar un café con mi padre.
You always are angry	Tú siempre estás enojado.
It is important to sleep well.	Es importante dormir bien.
This morning I am very tired.	Esta mañana estoy muy cansado.
My mother is angry with my father.	Mi mamá está enojada con mi papá.
This morning I am very tired and I need more coffee.	Esta mañana estoy muy cansado y necesito más café.
My mother is very angry today.	Mi madre está muy enojada hoy.
The girl is sad in the school	La niña está triste en la escuela.
My sister is always bored.	Mi hermana siempre está aburrida.
You never want to study with me.	Tú nunca quieres estudiar conmigo.
My friend is never happy with his work.	Mi amigo nunca está feliz con su trabajo.
I want to enjoy the day.	Quiero disfrutar el día.
She is always sick or worried.	Ella está siempre enferma o preocupada.
Her mother is tired and needs to sleep	Su mamá está cansada y necesita dormir.
I am surprised and angry.	Estoy sorprendido y enojado.
No, my father is not busy today	No, mi papá no esta ocupada hoy.
My sister is sad.	Mi hermana está triste.
I am also angry.	Yo también estoy enojado.
How many friends do you have?	¿Cuántos amigos tienes?
I do not need holidays.	No necesito vacaciones.
How many secretaries do you have	¿Cuántas secretarias tienes?
Four or five cities.	Cuatro o cinco ciudades.
I have some questions for the teacher	Tengo unas preguntas para la maestra.
We never study at home	Nosotros nunca estudiamos en casa.
We are daughters. 	Nosotras somos hijas.
You and I speak English very well	Tú y yo hablamos inglés muy bien.
The teacher is speaking with two men.	El maestro habla con dos hombres.
I want to work at two universities	Yo quiero trabajar en dos universidades.
I have a lot of friends in this class.	Yo tengo muchas amigas en esta clase.
How many women?	¿Cuántas mujeres?
How many books do you need	¿Cuántos libros necesitas?
We are men.	Nosotros somos hombres.
They are students at the university.	Ellas son estudiantes en la universidad.
I need a vacation now	Yo necesito unas vacaciones ahora.
How many students study in the library?	¿Cuántos estudiantes estudian en la biblioteca?
We are not the bosses.	Nosotros no somos los jefes.
They are women.	Ellas son mujeres.
Yes, they always study for class.	Sí, siempre estudian para la clase.
We are mothers.	Nosotras somos madres.
How many daughters do you have?	¿Cuántas hijas tienes?
The class has three men and four women.	La clase tiene tres hombres y cuatro mujeres.
How many men study here?	¿Cuántos hombres estudian aquí?
This town does not have universities.	Este pueblo no tiene universidades.
We do not speak Portuguese.	Nosotros no hablamos portugués.
Where are the students from?	¿De dónde son los estudiantes?
I have some questions for the teacher.	Tengo unas preguntas para la maestra.
The player 	El jugador
The friend	El amigo
England has a lot of soccer players	Inglaterra tiene muchos jugadores de fútbol.
Why do you work on the weekends	¿Por qué trabajas los fines de semana?
The football players speak English.	Las jugadoras de fútbol hablan inglés.
The boy wants to be a football player	El niño quiere ser jugador de fútbol.
The teacher has many students.	La maestra tiene muchos estudiantes.
My father always works on the weekends.	Mi padre siempre trabaja los fines de semana.
The university has many students.	La universidad tiene muchas estudiantes.
We are not football players.	Nosotros no somos jugadores de fútbol.
Who has many businesses?	¿Quién tiene muchos negocios?
They never study on the weekends	Ellas nunca estudian los fines de semana.
You and I are friends.	Tú y yo somos amigos.
The red shirt is for my grandmother.	La camiseta roja es para mi abuela.
They do not wear these green shirts.	Ellos no usan estas camisetas verdes.
The t-shirts here are very interesting!	¡Las camisetas aquí son muy interesantes!
Yes these shoes are a little small.	Sí, estos zapatos son un poco pequeños.
Tomorrow I want to buy a green purse.	Mañana quiero comprar una cartera verde.
My daughter wants two pretty dresses for the dance	Mi hija quiere dos vestidos bonitos para el baile.
How many pants do you need?	¿Cuántos pantalones necesitas?
The red pants are not pretty.	Los pantalones rojos no son bonitos.
Do you have a red dress?	¿Tú tienes un vestido rojo?
The red shoes are new.	Los zapatos rojos son nuevos.
These t-shirts are very pretty.	Estas camisetas son muy bonitas.
My mother uses large wallets.	Mi mamá usa carteras grandes.
The green dress is very pretty.	El vestido verde es muy bonito.
The girl needs small t-shirts.	La niña necesita camisetas pequeñas.
How many red purses do you want to buy?	¿Cuántas carteras rojas quieres comprar?
This woman has some interesting dresses.	Esta mujer tiene unos vestidos interesantes.
Do you need new shoes again?	¿Ustedes necesitan zapatos nuevos otra vez?
These dresses are very small.	Estos vestidos son muy pequeños.
My boyfriend always wears red t-shirts.	Mi novio siempre usa camisetas rojas.
My Spanish teacher wears green dresses.	Mi maestra de español usa vestidos verdes.
The Mexican restaurant is very close.	El restaurante mexicano está muy cerca.
The students are at the bus stop.	Los estudiantes están en la parada del autobús.
The door is small.	La puerta es pequeña.
Where is my train?	¿Dónde está mi tren?
The train station is near the parks.	La estación de tren está cerca de los parques.
We are in a big city.	Nosotros estamos en una ciudad grande.
To the left.	A la izquierda.
This bank does not have money!	¡Este banco no tiene dinero! 
Do you want to take a taxi?	¿Quieres tomar un taxi?
The metro station has many trains.	La estación de metro tiene muchos trenes.
The universities are far from the park.	Las universidades están lejos del parque.
Do you want to travel with me?	¿Quieres viajar conmigo?
Where are we now?	¿Dónde estamos ahora?
Where is the park?	¿Dónde está el parque?
This city has many banks.	Esta ciudad tiene muchos bancos.
The town has two supermarkets.	El pueblo tiene dos supermercados.
Where is the bus station?	¿Dónde está la estación de autobuses?
The cafe is far from the supermarket.	El café está lejos del supermercado.
Do you need to go to the bank?	¿Necesitas ir al banco?
The university is near here.	La universidad está cerca de aquí.
Do you want Mexican or Italian food?	¿Quieres comida mexicana o italiana?
I want to enjoy an afternoon with friends.	Yo quiero disfrutar una tarde con amigos.
Father, this rice is very good.	Papá, este arroz es muy bueno.
They want chicken with a salad.	Ellos quieren pollo con una ensalada.
What do they write?	¿Qué escriben ellos?
We do not want to walk today.	Nosotros no queremos caminar hoy.
We want to live together.	Nosotros queremos vivir juntos.
I want an enjoyable vacation.	Yo quiero unas vacaciones divertidas.
My wife and I live in a beautiful house.	Mi esposa y yo vivimos en una casa bonita.
The girl does not want to open her book.	La niña no quiere abrir su libro.
When do you want to read the newspaper?	¿Cuándo quieres leer el periódico?
We eat a lot of chicken.	Nosotros comemos mucho pollo.
I do not have boring books.	Yo no tengo libros aburridos.
Este pueblo tiene dos playas.	Este pueblo tiene dos playas.
He needs a lot of water.	Él necesita mucha agua.
I read many books in the summer.	Yo leo muchos libros en el verano.
My family has two houses at the beach.	Mi familia tiene dos casas en la playa.
Summers here are always enjoyable.	Los veranos aquí siempre son divertidos.
They eat in many restaurants.	Ellas comen en muchos restaurantes.
The holidays are not boring.	Las vacaciones no son aburridas.
She eats at home	Ella come en casa.
We live in England.	Nosotras vivimos en Inglaterra.
You drink water.	Tú bebes agua.
Do you want to learn?	¿Usted quiere aprender?
They speak English.	Ellos hablan inglés.
They need to read this message.	Ellas necesitan leer este mensaje.
They buy chicken.	Ellos compran pollo.
She needs to leave now.	Ella necesita salir ahora.
We are learning English.	Nosotras aprendemos inglés.
We need to open this door.	Necesitamos abrir esta puerta.
We are reading books.	Nosotros leemos libros.
I want to eat an apple.	Quiero comer una manzana.
They want to work in a university.	Ellos quieren trabajar en una universidad.
We work in a school.	Nosotros trabajamos en una escuela.
They are leaving now.	Ellos salen ahora.
We are not opening this door.	Nosotras no abrimos esta puerta.
I need to buy a car.	Necesito comprar un carro.
I want to speak Spanish.	Quiero hablar español.
You need to write more.	Usted necesita escribir más.
We open the doors.	Nosotros abrimos las puertas.
Why do you like to draw?	¿Por qué te gusta dibujar?
I like this skirt because it's green.	Me gusta esta falda porque es verde.
The girl wants a cake for her birthday	La niña quiere un pastel para su cumpleaños.
Where are the dogs	¿Dónde están los perros?
I have an old car.	Yo tengo un carro viejo.
That boy's clothes are interesting	La ropa de ese chico es interesante.
My t-shirts are old but pretty.	Mis camisetas son viejas pero bonitas.
We want coffee with sugar	Nosotros queremos café con azúcar.
Where are the girls?	¿Dónde están las chicas?
I want to buy more chocolate.	Yo quiero comprar más chocolate.
The chocolate cakes are my favourite.	Los pasteles de chocolate son mis favoritos.
I have no favourite foods.	Yo no tengo comidas favoritas.
Do you have bread for the cheese?	¿Tienes pan para el queso?
She has two new bicycles.	Ella tiene dos bicicletas nuevas.
I want to buy that red purse.	Yo quiero comprar esa cartera roja.
She doesn't wear dresses but wears skirts.	Ella no usa vestidos, pero usa faldas.
Is this hat for him.	¿Este sombrero es para él?
I am using my mum's old purse.	Yo uso la cartera vieja de mamá.
We want two pretty hats.	Queremos dos sombreros bonitos.
That girl has a pretty bicycle.	Esa chica tiene una bicicleta bonita.
How many cakes do you want?	¿Cuántos pasteles quieres?
What food do you love?	¿Qué comida te encanta?
The cheese sandwich is very good.	El sándwich de queso es muy bueno.
hese are my favorite cheeses.	Estos son mis quesos favoritos. 
The boy wants to draw a dog.	El niño quiere dibujar un perro.
Chocolate has sugar.	El chocolate tiene azúcar.
That hat is for dad.	Ese sombrero es para papá.
This cake is for my grandfather.	Este pastel es para mi abuelo.
Do you want to eat something now?	¿Ustedes quieren comer algo ahora?
These are my favorite beaches.	Estas son mis playas favoritas.
I want coffee because I'm tired.	Yo quiero café porque estoy cansado.
I am happy with my new skirt	Yo estoy feliz con mi falda nueva.
How many dogs do you have?	¿Cuántos perros tienes?
Mister, do you want that shirt?	Señor, ¿usted quiere esa camisa?
I want a lot of cheese in my salad.	Quiero mucho queso en mi ensalada.
My boyfriend's car is not old.	El carro de mi novio no es viejo.
She wants this coffee because she has milk.	Ella quiere este café porque tiene leche.
These are my favourite pants.	Estos son mis pantalones favoritos.
Do you want more chocolate?	¿Quieres más chocolate?
Do you want to play with the boys?	¿Quieres jugar con los chicos?
On Mondays I get up at six.	Los lunes me levanto a las seis.
Do you go to Spain often?	¿Ustedes van a España a menudo?
She studies three hours every day.	Ella estudia tres horas todos los días.
We work at twelve.	Nosotros trabajamos a las doce.
She does not want to study on Saturdays.	Ella no quiere estudiar los sábados.
I always go to work by bus.	Yo siempre voy al trabajo en autobús.
When do you want to go to the movies.	¿Cuándo quieres ir al cine?
They also want to watch television.	Ellas también quieren mirar televisión.
You never go to the library.	Tú nunca vas a la biblioteca.
We eat together every night.	Comemos juntos todas las noches.
She always is busy at eleven.	Ella siempre está ocupada a las once.
I need to work on Saturdays.	Necesito trabajar los sábados.
I always study from ten to twelve.	Yo siempre estudio de diez a doce.
They go to the library every day.	Ellas van a la biblioteca todos los días.
I go to the office every Monday.	Yo voy a la oficina todos los lunes.
I need to sleep for eight hours.	Necesito dormir ocho horas.
The boy always wants to watch television.	El niño siempre quiere mirar televisión.
My brother wants to go to the movies tomorrow.	Mi hermano quiere ir al cine mañana.
Are you going to the movies tonight	¿Vas al cine esta noche?
You go to the office by bus.	Tú vas a la oficina en autobús.
There is no living room in this house.	No hay una sala en esta casa.
Do you want to paint your bedroom?	¿Quieres pintar tu dormitorio?
The bedrooms are very modern.	Las habitaciones son muy modernas.
She has two refrigerators in the kitchen.	Ella tiene dos neveras en la cocina.
Where are the cell phones?	¿Dónde están los celulares?
Those windows are very big.	Esas ventanas son muy grandes.
The cell phones are on the bookcase.	Los celulares están sobre la estantería.
He is buying a house near the beach.	Él compra una casa cerca de la playa.
How many bedrooms does the house have?	¿Cuántos dormitorios tiene la casa?
Those bathrooms are not modern.	Esos baños no son modernos.
She cleans the bathroom every day.	Ella limpia el baño todos los días.
What are you buying for the new house?	¿Qué compras para la casa nueva?
My books are under the desk.	Mis libros están debajo del escritorio.
Do you have a big bed?	¿Tú tienes una cama grande?
Is the living room window blue?	¿La ventana de la sala es azul?
We have two clocks in the office.	Tenemos dos relojes en la oficina.
You don't need two kitchens.	Tú no necesitas dos cocinas.
The cat is in the fridge.	¡El gato está en la nevera!
The girls want a big bedroom.	Las chicas quieren un dormitorio grande.
There is a kitchen in the house.	Hay una cocina en la casa.
Sir, can you bring the check? 	Señor, ¿puede traer la cuenta?
We need more drinks on this table.	Necesitamos más bebidas en esta mesa.
I don't have a fork.	No tengo tenedor.
What drink do you want?	¿Qué bebida quiere usted?
We want to eat chicken with potatoes.	Queremos comer pollo con patatas.
We want to eat dessert.	Queremos comer postre.
Do you want to pay now?	¿Ustedes quieren pagar ahora?
This soup does not have beans.	Esta sopa no tiene frijoles.
I would like chicken with salad.	Quisiera pollo con ensalada.
Do you want to eat a Spanish dish?	¿Quieres comer un plato español?
We want the meat, but without cheese.	Queremos la carne, pero sin queso.
I have two knives.	Tengo dos cuchillos.
Pardon we need forks.	Disculpe, necesitamos tenedores.
Do you want to use this knife?	¿Quieres usar este cuchillo?
Do you want a glass of water?	¿Quiere usted un vaso de agua?
What desserts do you have?	¿Qué postres tiene?
This fish is very good.	Este pescado es muy bueno.
Waiters work in restaurants.	Los camareros trabajan en restaurantes.
I am paying for the chicken and the fries.	Yo pago el pollo y las patatas fritas.
The waitresses speak good Spanish.	Las camareras hablan bien español.
Many families are small.	Muchas familias son pequeñas.
My brother likes soccer.	A mi hermano le gusta el fútbol.
Is your husband here?	¿Está tu marido aquí?
Your parents are Mexican?	¿Tus padres son mexicanos?
These are my favorite movies.	Estas son mis películas favoritas.
The sports are interesting.	Los deportes son interesantes.
Basketball is my favourite.	El baloncesto es mi favorito.
Are your Spanish friends nice?	¿Tus amigas españolas son simpáticas?
I have two younger sisters.	Tengo dos hermanas menores.
Our mothers are American.	Nuestras madres son americanas.
My friends are Mexican.	Mis amigas son mexicanas.
Do you want to listen to music now?	¿Quieres escuchar música ahora?
My brother goes to a lot of concerts in the summer.	Mi hermano va a muchos conciertos en el verano.
Do you have older brothers?	¿Tienes hermanos mayores?
Yo quiero tener un hermano menor. I want to have a younger brother.
My grandmother and I play the piano together.	Mi abuela y yo tocamos el piano juntas.
They are not nice to me.	Ellos no son simpáticos conmigo.
They play the guitar in the concert.	Ellos tocan la guitarra en el concierto.
Do you want to play music now?	¿Quieres tocar música ahora?
I play the guitar because it is fun	Yo toco la guitarra porque es divertido.
Where do you want to go shopping?	¿Dónde quieres ir de compras?
Size sixteen is big for me.	La talla dieciséis es grande para mí.
We want to look for another store.	Queremos buscar otra tienda.
Do you want to go shopping today?	¿Quieres ir de compras hoy?
Do you want to buy something for me?	¿Quieres comprar algo para mí?
Papa, I would like to buy something for you.	Papá, quisiera comprar algo para ti.
Sir, are you open today?	Señor, ¿usted abre hoy?
Those pants are not for me.	Esos pantalones no son para mí.
Does the store close on the weekend?	¿La tienda cierra los fines de semana?
There are a lot of interesting shops here.	Hay muchas tiendas interesantes aquí.
They want to look for some t-shirts.	Ellos quieren buscar unas camisetas.
I go shopping every Saturday.	Yo voy de compras todos los sábados.
I want to buy a hat for you.	Quiero comprar un sombrero para ti.
We want to go shopping today.	Queremos ir de compras hoy.
This store never closes in the afternoon.	Esta tienda nunca cierra en la tarde.
Mother, the red t-shirt is for me	Mamá, la camiseta roja es para mí.
My mother wants to look for a new cellphone.	Mi madre quiere buscar un celular nuevo.
Felipe, these pants are for you.	Felipe, estos pantalones son para ti.
The hat costs five dollars.	El sombrero cuesta quince dólares.
The skirt costs thirteen dollars	La falda cuesta trece dólares.
Do the pants cost fourteen pesos?	¿Los pantalones cuestan catorce pesos?
 What size do you need sir?	¿Qué talla necesita, señor?
 The shop is not open on Sundays.	La tienda no abre los domingos.
 I don't buy a lot of clothes with nineteen pesos.	No compro mucha ropa con diecinueve pesos.
 The prices are expensive here.	Los precios son caros aquí.
 That boy is sixteen.	Ese chico tiene dieciséis años.
 I need a credit card.	Yo necesito una tarjeta de crédito.
	¡Es muy caro! It is very expensive.
 What is the price of this clock ?	¿Cuál es el precio de este reloj?
 Where are the fitting rooms?	¿Dónde están los probadores?
 The t-shirt is for you or for me?	¿La camiseta es para ti o para mí?
 This skirt is beautiful but expensive.	Esta falda es bonita pero cara.
 The girls are in the fitting room.	Las chicas están en el probador.
 I look for some green pants.	Busco unos pantalones verdes.
 They are looking for some cheap skirts.	Ellas buscan unas faldas baratas.
 We have big sizes and small.	Tenemos tallas grandes y pequeñas.
 We are not angry now.	No estamos enojadas ahora.
 This bathroom is big.	Este baño es grande.
 They are very surprised.	Ellos están muy sorprendidos.
 She is a responsible person.	Ella es una persona responsable.
 My parents are also busy.	Mis padres también están ocupados.
 My parents are not angry.	Mis padres no están enojados.
 That boy is very studious.	Ese niño es muy estudioso.
 You are very good looking.	Tú eres muy guapo.
 We are happy with the new house.	Estamos felices con la casa nueva.
 My sisters are not worried.	Mis hermanas no están preocupadas.
 Those shoes are very clean.	Esos zapatos están muy limpios.
 The bosses are busy in the office.	Las jefas están ocupadas en la oficina.
 We are nervous here.	Nosotros estamos nerviosos aquí.
 My bedroom is dirty now.	Mi dormitorio está sucio ahora.
 The banks are not open on Sundays.	Los bancos no están abiertos los domingos.
 This shirt is yellow.	Esta camisa es amarilla.
 My friends are sad today.	Mis amigos están tristes hoy.
 The office is closed on Tuesdays.	La oficina está cerrada los martes.
 Those girls are tall.	Esas chicas son altas.
 They are surprised.	Ellas están sorprendidas.
 Do you want to spend time with me today?	¿Quieres pasar tiempo conmigo hoy?
 We have a present for you 	Tenemos un regalo para ti.
 Those pants are very pretty.	Aquellos pantalones son muy bonitos.
 What does he like?	¿A él qué le gusta?
 We ride horseback near the river.	Montamos a caballo cerca del río.
 Normally I like going to the beach.	Normalmente me gusta ir a la playa.
 Is this guitar for us?	¿Esta guitarra es para nosotros?
 The boy enjoys his presents.	El niño disfruta sus regalos.
 Do you want to play with the ball?	¿Quieres jugar con la pelota?
 We are enjoying a week in the city.	Disfrutamos una semana en la ciudad.
 I am enjoying a day at the beach.	Yo disfruto un día en la playa.
 My parents are walking on the beach.	Mis padres caminan en la playa.
 These pants are not for her.	Estos pantalones no son para ella.
 Do you want those shirts?	¿Ustedes quieren aquellas camisas?
 What do you want to buy for him?	¿Qué quieres comprar para él?
 They are enjoying a coffee with their friends.	Ellos disfrutan un café con amigos.
 They want to ride the bicycles in the park.	Ellos quieren montar las bicicletas en el parque.
 Are you enjoying this beautiful day?	¿Tú disfrutas este día bonito?
 This shirt is for him.	Esta camisa es para él.
 The boy wants to play with the ball.	El niño quiere jugar con la pelota.
 I want to go to Germany in the summer.	Yo quiero ir a Alemania en el verano.
 The girl sees her father on Sundays	La niña ve a su padre los domingos.
 Who wants to call my grandfather?	¿Quién quiere llamar a mi abuelo?
 My husband is familiar with many places here.	Mi esposo conoce muchos lugares aquí.
 My grandfather wants to meet my wife.	Mi abuelo quiere conocer a mi esposa.
 Do you know a lot of people here?	¿Conoces a mucha gente aquí?
¡Amamos la playa! We love the beach!
 The teachers know the students very well.	Los maestros conocen a los estudiantes muy bien.
	¡Mi gato nunca ayuda a su hermano! My cat never helps his brother.
 Parents love their children.	Los padres aman a sus hijos.
 They are teaching my son Spanish.	Ellos enseñan español a mi hijo.
 I know a lot of doctors.	Yo conozco a muchos médicos.
 Usually we help mom in the morning.	Usualmente ayudamos a mamá en la mañana.
 I want to visit that place.	Quiero visitar ese lugar.
 The girls visit their grandmother.	Las niñas visitan a su abuela.
 I watch a lot of movies.	Yo veo muchas películas.
 Parents need to love their children.	Los padres necesitan amar a sus hijos.
 My parents want to visit different towns.	Mis padres quieren visitar diferentes pueblos.
 We know your brother.	Nosotros conocemos a tu hermano.
 The girl is teaching her grandfather Spanish.	La niña enseña español a su abuelo.
 Many adults here are young.	Muchos adultos aquí son jóvenes.
 How old are your parents?	¿Cuántos años tienen tus padres?
 My friends are twenty two years old.	Mis amigos tienen veintidós años.
 We have twenty-two dollars.	Nosotras tenemos veintidós pesos.
 The girl is not cold.	La niña no tiene frío.
 Are you twenty-one years old? 	¿Tú tienes veintiún años?
 This cat is always sleepy.	Este gato siempre tiene sueño.
 Are you twenty-five years old?	¿Tú tienes veinticinco años?
 We are thirsty.	Nosotros tenemos sed.
 They want two juices.	Ellos quieren dos jugos.
 How old are you?	¿Cuántos años tienes tú?
 I have on a pretty coat.	Tengo puesto un abrigo bonito.
 I want water because I am hot.	Quiero agua porque tengo calor.
 I'm hungry now.	Yo tengo hambre ahora.
 Do you feel like going shopping?	¿Tienes ganas de ir de compras?
 She is twenty two years old.	Ella tiene veintidós años.
 I have number twenty one.	Tengo el número veintiuno.
 Do you want these brown pants?	¿Quieres estos pantalones marrones?
 My parents are young.	Mis padres son jóvenes.
 Are you afraid?	¿Ustedes tienen miedo?
 She has two long skirts.	Ella tiene dos faldas largas.
 My brother is twenty-three years old.	Mi hermano tiene veintitrés años.
 We have three long dresses.	Tenemos tres vestidos largos.
 The day has twenty-four hours.	El día tiene veinticuatro horas.
 We don't call you often.	No te llamamos a menudo.
 My mother needs me today	Mi mamá me necesita hoy.
 I call you a lot.	Yo te llamo mucho.
 You never call us.	Tú nunca nos llamas.
 The teacher reads us a book.	El maestro nos lee un libro.
 The French course is very interesting.	El curso de francés es muy interesante.
 Many teachers know us here.	Muchos maestros nos conocen aquí.
 She does not listen to me.	Ella no me escucha.
 What is dad buying us?	¿Qué nos compra papá?
 You don't love me.	Tú no me quieres.
 My father buys me a guitar.	Mi papá me compra una guitarra.
 My parents call me on Sundays.	Mis padres me llaman los domingos.
	¿Cuándo nos visita nuestra abuela?	 When is our grandmother visiting us.
 Yes I know you.	Sí, yo te conozco.
 I always need you.	Siempre te necesito.
 I am helping you with the food.	Yo te ayudo con la comida.
 You are helping me a lot.	Me ayudas mucho.
 My sisters never help us.	Mis hermanas nunca nos ayudan.
 They never listed to us.	Ellas nunca nos escuchan.
 They learn German in the school.	Ellos aprenden alemán en la escuela.
 We make dinner early in the evening.	Hacemos la cena temprano en la noche.
 Are you making breakfast today?	¿Tú haces el desayuno hoy?
 Mother does not have an easy job.	Mamá no tiene un trabajo fácil.
 We have two weeks of holidays.	Tenemos dos semanas de vacaciones.
 What are you doing here?	¿Qué hacen ustedes aquí?
 She leaves at eight thirty.	Ella sale a las ocho y media.
 It's a little late now.	Es un poco tarde ahora.
 I take a taxi every day.	Yo tomo un taxi todos los días.
 I am making a chocolate cake.	Yo hago un pastel de chocolate.
¡Mi gato nunca quiere ducharse! My cat never wants to shower!
 When do you leave from work?	¿Cuándo sales del trabajo?
 He does not want to get up before eight.	Él no quiere levantarse antes de las ocho.
 My brother never makes his bed.	Mi hermano nunca hace su cama.
 School is always difficult.	La escuela siempre es difícil.
 These children eat too much.	Estos niños comen demasiado.
 Usually I have a lot of homework.	Usualmente yo tengo mucha tarea.
 They are not taking the bus today.	Ellos no toman el autobús hoy.
 Are you taking a taxi or the bus?	¿Tú tomas un taxi o el autobús?
 What do you want to eat for lunch?	¿Qué quieres comer en el almuerzo?
 The boy does not want to put on the shoes.	El niño no quiere ponerse los zapatos.
